 R 800 54554545

 NO textures/greystone.xpm
 SO textures/wood.xpm
 WE textures/redbrick.xpm
 EA textures/purplestone.xpm
 S textures/barrel.xpm 

 F 100,40,0

 C     0,213,255






























1111111111111111111111111111
1000S00000000210000000000001
1000000000000010000000000001
1202000000000010000000000201
111111011111111000000000000111
     1000000000000000000000001
     1111111111000000000002101
              1000000000000101
            111111111111111101
            100000000000000001
            101111111111111111
            100001
            111101
               101
               101
               101
1111111111111111011111111111111111111
1000000000000000000000000000000000001
1000000000000200000200000002000000021
1000000000000000000000000000000000021
1111111111111111111111111111111111111