 R      800 600







                                                             

NO north
SO south
WE west
EA east
S sprite



                               F               220,100,0


  C      225,30,0

 11111111111111111111111111111111111111111111111111111111111111111111111111111111111
 10000000000000000000000000000000000000000000000000000000000000000000000000000000001                                                   
 10000000000000000000000000000000000000000000000000000000000000000000000000000000001
 10000000000000000000000000000000000000000000000000000000000000000000000000000000001
 10000000000000000000000000000000000000000000000000000000000000000000000000000000001
 10000000000000000000000000000000000000000000000000000000000000000000000000000000001
 10000000000000000000000000000000000000000000000000000000000000000000000000000000001
 10000000000000000000000000000000000000000000000000000000000000000000000000000000001
 10000000000000000000000000000000000000000000000000000000000000000000000000000000001
 10000000000000000000000000000000000000000000000000000000000000000000000000000000001
 10000000000000000000000000000000000000000000000000000000000000000000000000000000001
 10000000000000000000000000000000000000000000000000000000000000000010000000000000001
 10000000000000000000000000000000000000000000000000000000000000000000000000000000001
 10000W00000000000000000000000000000000000000000000000000111000000010000000000000001
 10000000000000000000000000000000000000000000000000000000111000000000000000000000001
 10000000000000000000000000000000000000000000000000000000000000000010000000000000001
 10000000000000000000000000000000000000000000000000000000000000000000000000000000001
 10000000000000000000000000000000000000000000000000000000000000100010000000000000001
 10000000000000000000000000000000000000000000000000000000000000000000000000000000001
 10000000000000000000000000000000000000000000000000000000000000000000000000000000001
 10000000000000000000000000000000000000000000000000000000000000000000000000000000001
 10000000000000000000000000000000000000000000000000000000000000000000000000000000001
 10000000000000000000000000000000000000000000000000010000000000000000000000000000001
 10000000000000000000000000000000000000000000000000010000000000000000000000000000001
 10000000000000000000000000000000000000000000000000010000000000000000000000000000001
 10000000000000000000000000000000000000000000000000010000000000000000000000000000001
 10000000000000000000000000000000000000000000000000000000000000000000000000000000001
 10000000000010000000000000010000000000000010000000000000000000100000000000000000001
 10000000000000000000000000000000000000000000000000000000000000000000000000000000001
 10000000000000000000000000000000000000000000000000000000000000000000000000000000001
 10000000000000000000000000000000000000000000000000000000000000000000000000000000001
 11111111111111111111111111111111111111111111111111111111111111111111111111111111111


