 R    800 600







                                                             

NO textures/greystone.xpm
SO textures/wood.xpm
WE textures/redbrick.xpm
EA textures/east.xpm
S sprite


 F               100,100,100


  C      240,250,255

        1111111111111111111111111
        1000000000110000100000001
        1011000001110000002000001
        1001000000000000000000001
111111111011000001110000000000001
100000000011000001110111111011111
11110111111111011100000010001
11110111111111011101010010001
11000000110101011100000001001
100020000000000011000000E0001
10000000000000001101010000001
1100000111010101111101111000111
11110111 1110101 101111010001
11111111 1111111 111111111111