R 0 0 






                                                             

NO textures/greystone.xpm
SO textures/wood.xpm
WE textures/redbrick.xpm
EA textures/purplestone.xpm
S textures/cage_cat.xpm


 F               100,40,0


  C      0,213,255

111111111111111111111111111111111111111111111111111111111111111111111111111111111111111111111111111111111111111111111111111111111111111
122222222222222222222222222222222022222222222222222222222222222222022222222222222222222222222222222202222222222222222222222222222222201
122222222222222222222222222222222022222222222222222222222222222222022222222222222222222222222222222202222222222222222222222222222222201
122222222222222222222222222222222022222222222222222222222222222222022222222222222222222222222222222202222222222222222222222222222222201
122222222222222222222222222222222122222222222222222222222222222222022222222222222222222222222222222202222222222222222222222222222222201
122222222222222222222222222222222022222222222222222222222222222222022222222222222222222222222222222202222222222222222222222222222222201
122222222222222222222222222222222022222222222222222222222222222222022222222222222222222222222222222202222222222222222222222222222222201
122222222222222222222222222222222022222222222222222222222222222222022222222222222222222222222222222202222222222222222222222222222222201
122222222222222222222222222222222022222222222222222222222222222222022222222222222222222222222222222202222222222222222222222222222222201
122222222222222222222222222222222022222222222222222222222222222222022222222222222222222222222222222202222222222222222222222222222222201
122222222222222222222222222222222022222222222222222222222222222222022222222222222222222222222222222202222222222222222222222222222222201
122222222222222222222222222222222022222222222222222222222222222222022222222222222222222222222222222202222222222222222222222222222222201
122222222222222222222222222222222022222222222222222222222222222222022222222222222222222222222222222202222222222222222222222222222222201
122222222222222222222222222222222022222222222222222222222222222222022222222222222222222222222222222202222222222222222222222222222222201
122222222222222222222222222222222022222222222222222222222222222222022222222222222222222222222222222202222222222222222222222222222222201
122222222222222222222222222222222022222222222222222222222222222222022222222222222222222222222222222202222222222222222222222222222222201
122222222222222222222222222222222022222222222222222222222222222222022222222222222222222222222222222202222222222222222222222222222222201
122222222222222222222222222222222022222222222222222222222222222222022222222222222222222222222222222202222222222222222222222222222222201
122222222222222222222222222222222022222222222222222222222222222222022222222222222222222222222222222202222222222222222222222222222222201
122222222222222222222222222222222022222222222222222222222222222222022222222222222222222222222222222202222222222222222222222222222222201
122222222222222222222222222222222022222222222222222222222222222222022222222222222222222222222222222202222222222222222222222222222222201
122222222222222222222222222222222022222222222222222222222222222222022222222222222222222222222222222202222222222222222222222222222222201
122222222222222222222222222222222022222222222222222222222222222222022222222222222222222222222222222202222222222222222222222222222222201
122222222222222222222222222222222022222222222222222222222222222222022222222222222222222222222222222202222222222222222222222222222222201
122222222222222222222222222222222022222222222222222222222222222222022222222222222222222222222222222202222222222222222222222222222222201
122222222222222222222222222222222022222222222222222222222222222222022222222222222222222222222222222202222222222222222222222222222222201
122222222222222222222222222222222022222222222222222222222222222222022222222222222222222222222222222202222222222222222222222222222222201
122222222222222222222222222222222022222222222222222222222222222222022222222222222222222222222222222202222222222222222222222222222222201
122222222222222222222222222222222022222222222222222222222222222222022222222222222222222222222222222202222222222222222222222222222222201
100000000000000000000000000000000000000000000000000000000000000000000000000000000000000000000000000000000000000000000000000000000000001
100000000000000000000000000000000000000000000000000000000000000000000000000000000000000000000000000000000000000000000000000000000000001
100000000000000000000000000000000000000000000000000000000000000000N00000000000000000000000000000000000000000000000000000000000000000001
111111111111111111111111111111111111111111111111111111111111111111111111111111111111111111111111111111111111111111111111111111111111111